WE ./txtr/wall_1.xpm
EA ./txtr/wall_2.xpm
NO ./txtr/wall_3.xpm
SO ./txtr/wall_4.xpm



C 0,202,225
F 119,73,55



111111111111111111111111111111111
100000000000000000000000000000001
100000000000000000000000000000001
100000000000000000000000000000001
100000000000000000000000000000001
100000000000000000000000000000001
100000000000000000000000000000001
100000000000000000000000000000001
100000000010000000010000000000001
100000000000000000000000000000001
100000000000000000000000000000001
100000000000000000000000000000001
100000000000000000000000000000001
100000000000000000000000000000001
100000000000000000000000000000001
10000000000000N000000000000000001
100000000000000000000000000000001
111111111111111111111111111111111