SO ./path_to_the_south_texture
WE ./path_to_the_west_texture
C 225,030,166
F 222,100,100
EA ./path_to_the_east_texture
NO ./path_to_the_north_texturef


        1111111111111111111111111
        1000000000011100000000001
        1011000001111000000000001
        1001000000000000000000001
11111111101100000111000000000001
100000000011000001110111111111111
11110111111111011100000010001
11110111111111011101010010001
11000000110101011100000010001
10000000000000001100000010001
10000000000000001101010010001
11000001110101011111011110N0111
11110111110101101111010001
1111111 111111111111111111