WE ./txtr/wall2.xpm
EA ./txtr/last.xpm
NO ./txtr/Capture.xpm
SO ./txtr/lwst.xpm




C 0,202,225
F 119,73,55


   11111111111111111111111111111111111111111111111111
   1011010111011001010011000000000000000000000001
11101101011101100001001100000000000E000000000001
   1011010111011000000011000000000000000000000001
111011010111011001010011000000000000000000000001
110011001010011000000000000000000000001111111111
10011111011111000000000000000000000001
10011000000011000000000000000000000001
10011000000011000000000000000000000001
10011010101011000000011000000110000001
11111000000011000000000111111000000001
11111000000011000000000111111000000001
10011111011111000000011000000110000001
1001111101111100100000000000000000000011
1000000000000000000000000000000000000001
100110001010110000000000000000000000011
11111111111111111111111111111111111111