WE ./path_to_the_west_texture         
EA ./path_to_the_east_texture
NO ./path_to_the_north_texturef
SO ./pth_to_the_south_texture




C 225,030,0     
F 222,100,100




        11111111111111111111111111       
        100000000000100110000000001111111
        111111111011000001111110100000001
        10100000000000000000000110110111
1111111101100000111000000000001111111
10000000001100000111011110111111
11110111111111011100000010001
11110111111111011101010010001
10000001101011111000000100011
1000000000011110110000001000111
10000000000011111111101010010001
1000001110101011111011110000S0011111
1111001001010110111101000101111
111111111111111111111111111111