WE ./path_to_the_west_texture         
EA ./path_to_the_east_texture
NO ./path_to_the_north_texturef
SO ./pth_to_the_south_texture




C 225,030,0     
F 222,100,100




        11111111111111111111111111       
        100000000000100110000000001111111
        1111111110110000011111101000000011111
        1010000000000000000000000000000000001
111111110110000011100000000000111111111111111
10000000001100000111011000111111
11110111111111011100000000001
11110111111111011101010000001
10000001101011111000000100011
10000000000111101100000000001111
1000000000001111111110100E0010001
100000111010101111101111000000011111
1111001001010110111101000101111
111111111111111111111111111111